000000000000000000000000000000000000000000000000000000000000000000000000000000000000000000000000000000000000000000000000000000000
0 3111111111113 0 3111111111113 0 3111111111113 0 3111111111113 0 3111111111113 0 3111111111113 0 3111111111113 0 3111111111113 0
030101010101010303010101010101030301010101010103030101010101010303010101010101030301010101010103030101010101010303010101010101030
011111111111111101111111111111110111111111111111011111111111111101111111111111110111111111111111011111111111111101111111111111110
010101010101010101010101010101010101010101010101010101010101010101010101010101010101010101010101010101010101010101010101010101010
011111111111111101111111111111110111111111111111011111111111111101111111111111110111111111111111011111111111111101111111111111110
010101010101010101010101010101010101010101010101010101010101010101010101010101010101010101010101010101010101010101010101010101010
011111111111111101111111111111110111111111111111011111111111111101111111111111110111111111111111011111111111111101111111111111110
010101010101010101010101010101010101010101010101010101010101010101010101010101010101010101010101010101010101010101010101010101010
011111111111111101111111111111110111111111111111011111111111111101111111111111110111111111111111011111111111111101111111111111110
030101010101010303010101010101030301010101010103030101010101010303010101010101030301010101010103030101010101010303010101010101030
0 3111111111113 0 3111111111113 0 3111111111113 0 3111111111113 0 3111111111113 0 3111111111113 0 3111111111113 0 3111111111113 0
0 3111111111113 0 3111111111113 0 3111111111113 0 3111111111113 0 3111111111113 0 3111111111113 0 3111111111113 0 3111111111113 0
030101010101010303010101010101030301010101010103030101010101010303010101010101030301010101010103030101010101010303010101010101030
011111111111111101111111111111110111111111111111011111111111111101111111111111110111111111111111011111111111111101111111111111110
010101010101010101010101010101010101010101010101010101010101010101010101010101010101010101010101010101010101010101010101010101010
011111111111111101111111111111110111111111111111011111111111111101111111111111110111111111111111011111111111111101111111111111110
010101010101010101010101010101010101010101010101010101010101010101010101010101010101010101010101010101010101010101010101010101010
011111111111111101111111111111110111111111111111011111111111111101111111111111110111111111111111011111111111111101111111111111110
010101010101010101010101010101010101010101010101010101010101010101010101010101010101010101010101010101010101010101010101010101010
011111111111111101111111111111110111111111111111011111111111111101111111111111110111111111111111011111111111111101111111111111110
030101010101010303010101010101030301010101010103030101010101010303010101010101030301010101010103030101010101010303010101010101030
0 3111111111113 0 3111111111113 0 3111111111113 0 311111111111320 3111111111113 0 3111111111113 0 3111111111113 0 3111111111113 0
0 3111111111113 0 3111111111113 0 3111111111113 0 3111111111113 0 3111111111113 0 3111111111113 0 3111111111113 0 3111111111113 0
030101010101010303010101010101030301010101010103030101010101010303010101010101030301010101010103030101010101010303010101010101030
011111111111111101111111111111110111111111111111011111111111111101111111111111110111111111111111011111111111111101111111111111110
010101010101010101010101010101010101010101010101010101010101010101010101010101010101010101010101010101010101010101010101010101010
011111111111111101111111111111110111111111111111011111111111111101111111111111110111111111111111011111111111111101111111111111110
010101010101010101010101010101010101010101010101010101010101010101010101010101010101010101010101010101010101010101010101010101010
011111111111111101111111111111110111111111111111011111111111111101111111111111110111111111111111011111111111111101111111111111110
010101010101010101010101010101010101010101010101010101010101010101010101010101010101010101010101010101010101010101010101010101010
011111111111111101111111111111110111111111111111011111111111111101111111111111110111111111111111011111111111111101111111111111110
030101010101010303010101010101030301010101010103030101010101010303010101010101030301010101010103030101010101010303010101010101030
0 3111111111113 0 3111111111113 0 3111111111113 0 3111111111113 0 3111111111113 0 3111111111113 0 3111111111113 0 3111111111113 0
0 3111111111113 0 3111111111113 0 3111111111113 0 3111111111113 0 3111111111113 0 3111111111113 0 3111111111113 0 3111111111113 0
030101010101010303010101010101030301010101010103030101010101010303010101010101030301010101010103030101010101010303010101010101030
011111111111111101111111111111110111111111111111011111111111111101111111111111110111111111111111011111111111111101111111111111110
010101010101010101010101010101010101010101010101010101010101010101010101010101010101010101010101010101010101010101010101010101010
011111111111111101111111111111110111111111111111011111111111111101111111111111110111111111111111011111111111111101111111111111110
010101010101010101010101010101010101010101010101010101010101010101010101010101010101010101010101010101010101010101010101010101010
011111111111111101111111111111110111111111111111011111111111111101111111111111110111111111111111011111111111111101111111111111110
010101010101010101010101010101010101010101010101010101010101010101010101010101010101010101010101010101010101010101010101010101010
011111111111111101111111111111110111111111111111011111111111111101111111111111110111111111111111011111111111111101111111111111110
030101010101010303010101010101030301010101010103030101010101010303010101010101030301010101010103030101010101010303010101010101030
0 3111111111113 0 3111111111113 0 3111111111113 0 3111111111113 0 3111111111113 0 3111111111113 0 3111111111113 0 3111111111113 0
000000000000000000000000000000000000000000000000000000000000000000000000000000000000000000000000000000000000000000000000000000000