00000000000000000
023111111111113 0
03010101010101030
01111111111111110
01010101010101010
01111111111111110
01010101010101010
01111111111111110
01010101010101010
01111111111111110
03010101010101030
0 3111111111113 0
00000000000000000
