000000000000000004
023111111111113 04
030101010101010304
011111111111111104
010101010101010104
011111111111111104
010101010101010104444444444
011111111111111104
010101010101010104
011111111111111104
030101010101010304
0 3111111111113 04
000000000000000004
