000000000000000000000000000000000000000000000000000000000000000000000000000000000000000000000000000000000000000000000000000000000
0  11111111111  03 11111111111 20  11111111111  0  11111111111  0  11111111111  0  11111111111  0  11111111111  0  11111111111  0
0 0101010101010 0 0101010101010 0 0101010101010 0 0101010101010 0 0101010101010 0 0101010101010 0 0101010101010 0 0101010101010 0
011111111111111101111111111111110111111111111111011111111111111101111111111111110111111111111111011111111111111101111111111111110
010101010101010101010101010101010101010101010101010101010101010101010101010101010101010101010101010101010101010101010101010101010
011111111111111101111111111111110111111111111111011111111111111101111111111111110111111111111111011111111111111101111111111111110
010101010101010101010101010101010101010101010101010101010101010101010101010101010101010101010101010101010101010101010101010101010
011111111111111101111111111111110111111111111111011111111111111101111111111111110111111111111111011111111111111101111111111111110
010101010101010101010101010101010101010101010101010101010101010101010101010101010101010101010101010101010101010101010101010101010
011111111111111101111111111111110111111111111111011111111111111101111111111111110111111111111111011111111111111101111111111111110
0 0101010101010 0 0101010101010 0 0101010101010 0 0101010101010 0 0101010101010 0 0101010101010 0 0101010101010 0 0101010101010 0
000000000000000000000000000000000000000000000000000000000000000000000000000000000000000000000000000000000000000000000000000000000