00000000000000000
0  11111111111  0
0 0101010101010 0
01111111111111110
01010101010101010
01111111111111110
01010101010101010
01111111111111110
01010101010101010
01111111111111110
0 0101010101010 0
0  11111111111  0
00000000000000000