00000000000000000
02311111111111320
03010101010101030
01111111111111110
01010101010101010
01111111111111110
01010101010101010
01111111111111110
01010101010101010
01111111111111110
03010101010101030
02311111111111320
00000000000000000
