00000000000000000
02 11111111111 20
0 0101010101010 0
01111111111111110
01010101010101010
01111111111111110
01010101010101010
01111111111111110
01010101010101010
01111111111111110
0 0101010101010 0
02 11111111111 20
00000000000000000
