00000000000000000000000000000000
03 11111111111424111111111114440
0 010101010101044010101010101040
01111111111111111111111111111110
01010101010101011010101010101010
01111111111111111111111111111110
01010101010101011010101010101010
01111111111111111111111111111110
01010101010101011010101010101010
01111111111111111111111111111110
04010101010101044010101010101040
00000000000000000000000000000000