000000000000000
04 111101111 40
0 01010101010 0
011111110111110
010101010101010
011111110111110
010000010000010
011111011111110
010101010101010
011111010111110
010101010101010
0 11111101111 0
04 111111111 40
000000000000000