00000000000000000000000000000000000000000000000
03 11111111111 2 11111111111   11111111111    0
0 0101010101010  0101010101010 0101010101010000
01111111111111111111111111111111111111111111110
01010101010101011010101010101010101010101010000
01111111111111111111111111111111111111111111110
01010101010101011010101010101010101010101010000
01111111111111111111111111111111111111111111110
01010101010101011010101010101010101010101010000
01111111111111111111111111111111111111111111110
01111111111111111111111111111111111111111111110
01111111111111111111111111111111111111111111110
01111111111111111111111111111111111111111111110
01111111111111111111111111111111111111111111110
01111111111111111111111111111111111111111111110
01111111111111111111111111111111111111111111110
01111111111111111111111111111111111111111111110
01111111111111111111111111111111111111111111110
01111111111111111111111111111111111111111111110
01111111111111111111111111111111111111111111110
00000000000000000000000000000000000000000000000
