000000000000000
0 11111111111 0
011111111111110
011010101010110
011111101111110
011111111111110
011111101111110
011111111111110
011111101111110
011111111111110
011111101111110
011111111111110
011111101111110
0 11111111111 0
000000000000000